6              6
6  4        4  6
6   4  22  4   6
6    4    4    6
6     4  4     6
6 22   44   22 6
6     4  4     6
6    4    4    6
6   4  22  4   6
6  4        4  6
6              6
6000000000000006
6              6
6              6
655 555  555 556
6              6
6              6
6              6
6              6
6              6
6              6
6              6 
6              6
6              6
               