            
 1 5        5 1
  1 5      5 1   
   1 5    5 1    
    1 5  5 1
     1 55 1       
    1 5  5 1
   1 5    5 1
  1 5      5 1
 1 5        5 1
 00 00 00 00 00
GGGGGGGGGGGGGGGG              