6666666666666666
4444444444444444
3333333333333333
2222222222222222
1111111111111111
0000000000000000